------------------------------
-aaaaa------------------aaaaa-
-a---a------------------a---a-
-a---a------------------a---a-
-a---a------------------a---a-
-aaaaaaaaaaaaaaaaaaaaaaaaaaaa-
-----a------------------a-----
-----a------------------a-----
-----aaaaaaaaaaaaaaaaaaaa-----
-----a----a--------a----a-----
-----a----a--------a----a-----
-----aaaaaaaaaaaaaaaaaaaa-----
-----a------------------a-----
-----a------------------a-----
-aaaaaaaaaaaaaaaaaaaaaaaaaaaa-
-a---a------------------a---a-
-a---a------------------a---a-
-a---a------------------a---a-
-aaaaa------------------aaaaa-
------------------------------
# 1,1,east,male
# 28,1,south,female
# 28,28,west,male
# 1,28,north,female
